10 7 1 1 2
##########
#        #
#     ## o
#    #   #
#    #####
#        #
##########
0123456789